asphyxiate	SELF-STRANGULATION
asphyxiation	SELF-STRANGULATION
auto-mutilate	SELF-HARM
auto-mutilating	SELF-CUTTING
auto-mutilation	SELF-CUTTING
bang	SELF-HITTING
banging	SELF-HITTING
beat	SELF-HITTING
beating	SELF-HITTING
bite	SELF-BITING
biting	SELF-BITING
burn	SELF-BURNING
burning	SELF-BURNING
chop	SELF-CUTTING
chopping	SELF-CUTTING
cut	SELF-CUTTING
cutting	SELF-CUTTING
cutting	SELF-CUTTING
destruct	SELF-HARM
destruction	SELF-HARM
destructive	SELF-HARM
drown	SELF-HARM
drowning	SELF-HARM
electrocute	SELF-HARM
electrocuting	SELF-HARM
electrocution	SELF-HARM
gash	SELF-STABBING
gouge	SELF-STABBING
gouging	SELF-STABBING
hack	SELF-CUTTING
hacking	SELF-CUTTING
hang	SELF-STRANGULATION
hanging	SELF-STRANGULATION
hit	SELF-HITTING
hurt	SELF-HARM
hurting	SELF-HARM
immolate	SELF-BURNING
immolating	SELF-BURNING
immolation	SELF-BURNING
injure	SELF-HARM
injuring	SELF-HARM
injurious	SELF-HARM
injury	SELF-HARM
jump	SELF-BURNING
jumping	SELF-BURNING
kick	SELF-HITTING
kicking	SELF-HITTING
lacerate	SELF-CUTTING
lacerating	SELF-CUTTING
laceration	SELF-CUTTING
maim	SELF-HARM
maiming	SELF-HARM
mutilate	SELF-CUTTING
mutilating	SELF-CUTTING
mutilation	SELF-CUTTING
perforate	SELF-STABBING
perforating	SELF-STABBING
perforation	SELF-STABBING
pick	SKIN-PICKING
picking	SKIN-PICKING
pierce	SELF-STABBING
piercing	SELF-STABBING
pinch	SELF-HARM
pinching	SELF-HARM
poison	OVERDOSE
poisoning	OVERDOSE
pummel	SELF-HITTING
pummeling	SELF-HITTING
punch	SELF-HITTING
punching	SELF-HITTING
puncture	SELF-HITTING
puncturing	SELF-HITTING
rip	SELF-HARM
ripping	SELF-HARM
scald	SELF-BURNING
scalding	SELF-BURNING
scar	SELF-CUTTING
scarring	SELF-CUTTING
scratch	SELF-CUTTING
scratching	SELF-CUTTING
sever	SELF-CUTTING
severing	SELF-CUTTING
slash	SELF-CUTTING
slashing	SELF-CUTTING
slice	SELF-CUTTING
slicing	SELF-CUTTING
slit	SELF-CUTTING
slitting	SELF-CUTTING
smack	SELF-HITTING
stab	SELF-STABBING
stabbing	SELF-STABBING
strangle	SELF-STRANGULATION
strangling	SELF-STRANGULATION
tearing	SELF-HARM
throttle	SELF-STRANGULATION
throttling	SELF-STRANGULATION
whack	SELF-HITTING
whacking	SELF-HITTING
wound	SELF-HARM
wounding	SELF-HARM