# change to LEMMA post-eval
ago	TIME
at the age of	TIME
#at age	TIME # added post-eval
since	TIME
when	TIME
history	TIME
Hx	TIME
hx	TIME
h/o	TIME # added post-eval
use to	TIME
past	TIME
previous	TIME
previously	TIME
earlier	TIME
year old	TIME
at the time	TIME
at that time	TIME # added post-eval
tendency	TIME
#was	TIME
#has been	TIME
#had been	TIME
#has had	TIME
#have been	TIME
#having been	TIME
#having had	TIME
#have had	TIME